[
    [0, [3], 0],
    [0, [3], 10],
    [0, [3], 20],
    [0, [4], 50],
    [0, [4], 60],
    [0, [4], 70],
    [0, [4], 80],
    [0, [6], 100]
]